#####
#p  #
# oo#
# ..#
#####